https://exoplanetarchive.ipac.caltech.edu/docs/API_PS_columns.html

Planetary Systems Composite Parameters (PSCP)
Database Column Name	Table Label or Comment
pl_name	Planet Name
hostname	Host Name
pl_letter	Planet Letter
hd_name	HD ID
hip_name	HIP ID
tic_id	TIC ID
gaia_id	GAIA ID
sy_snum	Number of Stars
sy_pnum	Number of Planets
sy_mnum	Number of Moons
cb_flag	Circumbinary Flag
discoverymethod	Discovery Method
disc_year	Discovery Year
disc_refname	Discovery Reference
disc_pubdate	Discovery Publication Date
disc_locale	Discovery Locale
disc_facility	Discovery Facility
disc_telescope	Discovery Telescope
disc_instrument	Discovery Instrument
rv_flag	Detected by Radial Velocity Variations
pul_flag	Detected by Pulsar Timing Variations
ptv_flag	Detected by Pulsation Timing Variations
tran_flag	Detected by Transits
ast_flag	Detected by Astrometric Variations
obm_flag	Detected by Orbital Brightness Modulations
micro_flag	Detected by Microlensing
etv_flag	Detected by Eclipse Timing Variations
ima_flag	Detected by Imaging
dkin_flag	Detected by Disk Kinematics
pl_controv_flag	Controversial Flag
pl_orbper	Orbital Period [days]
pl_orbpererr1	Orbital Period Upper Unc. [days]
pl_orbpererr2	Orbital Period Lower Unc. [days]
pl_orbperlim	Orbital Period Limit Flag
pl_orbper_reflink	Orbital Period Reference
pl_orbsmax	Orbit Semi-Major Axis [au])
pl_orbsmaxerr1	Orbit Semi-Major Axis Upper Unc. [au]
pl_orbsmaxerr2	Orbit Semi-Major Axis Lower Unc. [au]
pl_orbsmaxlim	Orbit Semi-Major Axis Limit Flag
pl_orbsmax_reflink	Orbit Semi-Major Axis Reference
pl_rade	Planet Radius [Earth Radius]
pl_radeerr1	Planet Radius Upper Unc. [Earth Radius]
pl_radeerr2	Planet Radius Lower Unc. [Earth Radius]
pl_radelim	Planet Radius Limit Flag
pl_rade_reflink	Planet Radius Reference
pl_radj	Planet Radius [Jupiter Radius]
pl_radjerr1	Planet Radius Upper Unc. [Jupiter Radius]
pl_radjerr2	Planet Radius Lower Unc. [Jupiter Radius]
pl_radjlim	Planet Radius Limit Flag
pl_radj_reflink	Planet Radius Reference
pl_bmasse	Planet Mass or Mass*sin(i) [Earth Mass]
pl_bmasseerr1	Planet Mass or Mass*sin(i) [Earth Mass] Upper Unc.
pl_bmasseerr2	Planet Mass or Mass*sin(i) [Earth Mass] Lower Unc.
pl_bmasselim	Planet Mass or Mass*sin(i) [Earth Mass] Limit Flag
pl_bmasse_reflink	Planet Mass or Mass*sin(i) [Earth Mass] Reference
pl_bmassj	Planet Mass or Mass*sin(i) [Jupiter Mass]
pl_bmassjerr1	Planet Mass or Mass*sin(i) [Jupiter Mass] Upper Unc.
pl_bmassjerr2	Planet Mass or Mass*sin(i) [Jupiter Mass] Lower Unc.
pl_bmassjlim	Planet Mass or Mass*sin(i) [Jupiter Mass] Limit Flag
pl_bmassj_reflink	Planet Mass or Mass*sin(i) [Jupiter Mass] Reference
pl_bmassprov	Planet Mass or Mass*sin(i) Provenance
pl_dens	Planet Density [g/cm**3]
pl_denserr1	Planet Density Upper Unc. [g/cm**3]
pl_denserr2	Planet Density Lower Unc. [g/cm**3]
pl_denslim	Planet Density Limit Flag
pl_dens_reflink	Planet Density Reference
pl_orbeccen	Eccentricity
pl_orbeccenerr1	Eccentricity Upper Unc.
pl_orbeccenerr2	Eccentricity Lower Unc.
pl_orbeccenlim	Eccentricity Limit Flag
pl_orbeccen_reflink	Eccentricity Reference
pl_insol	Insolation Flux [Earth Flux]
pl_insolerr1	Insolation Flux Upper Unc. [Earth Flux]
pl_insolerr2	Insolation Flux Lower Unc. [Earth Flux]
pl_insollim	Insolation Flux Limit Flag
pl_insol_reflink	Insolation Flux Reference
pl_eqt	Equilibrium Temperature [K]
pl_eqterr1	Equilibrium Temperature Upper Unc. [K]
pl_eqterr2	Equilibrium Temperature Lower Unc. [K]
pl_eqtlim	Equilibrium Temperature Limit Flag
pl_eqt_reflink	Equilibrium Temperature Reference
pl_orbincl	Inclination [deg]
pl_orbinclerr1	Inclination Upper Unc. [deg]
pl_orbinclerr2	Inclination Lower Unc. [deg]
pl_orbincllim	Inclination Limit Flag
pl_orbincl_reflink	Inclination Reference
pl_tranmid	Transit Midpoint [days]
pl_tranmiderr1	Transit Midpoint Upper Unc. [days]
pl_tranmiderr2	Transit Midpoint Lower Unc. [days]
pl_tranmidlim	Transit Midpoint Limit Flag
pl_tranmid_systemref	Transit Midpoint Time Reference Frame and Standard
pl_tranmid_reflink	Time of Conjunction (Transit Midpoint) Reference
ttv_flag	Data show Transit Timing Variations
pl_imppar	Impact Parameter
pl_impparerr1	Impact Parameter Upper Unc.
pl_impparerr2	Impact Parameter Lower Unc.
pl_impparlim	Impact Parameter Limit Flag
pl_imppar_reflink	Impact Parameter Reference
pl_trandep	Transit Depth [%]
pl_trandeperr1	Transit Depth Upper Unc. [%]
pl_trandeperr2	Transit Depth Lower Unc. [%]
pl_trandeplim	Transit Depth Limit Flag
pl_trandep_reflink	 Transit Depth [%] Reference
pl_trandur	Transit Duration [hours]
pl_trandurerr1	Transit Duration Upper Unc. [hours]
pl_trandurerr2	Transit Duration Lower Unc. [hours]
pl_trandurlim	Transit Duration Limit Flag
pl_trandur_reflink	Transit Duration Reference
pl_ratdor	Ratio of Semi-Major Axis to Stellar Radius
pl_ratdorerr1	Ratio of Semi-Major Axis to Stellar Radius Upper Unc.
pl_ratdorerr2	Ratio of Semi-Major Axis to Stellar Radius Lower Unc.
pl_ratdorlim	Ratio of Semi-Major Axis to Stellar Radius Limit Flag
pl_ratdor_reflink	Ratio of Semi-Major Axis to Stellar Radius Reference
pl_ratror	Ratio of Planet to Stellar Radius
pl_ratrorerr1	Ratio of Planet to Stellar Radius Upper Unc.
pl_ratrorerr2	Ratio of Planet to Stellar Radius Lower Unc.
pl_ratrorlim	Ratio of Planet to Stellar Radius Limit Flag
pl_ratror_reflink	Ratio of Planet to Stellar Radius Reference
pl_occdep	Occultation Depth [%]
pl_occdeperr1	Occultation Depth Upper Unc. [%]
pl_occdeperr2	Occultation Depth Lower Unc. [%]
pl_occdeplim	Occultation Depth Limit Flag
pl_occdep_reflink	Occultation Depth Reference
pl_orbtper	Epoch of Periastron [days]
pl_orbtpererr1	Epoch of Periastron Upper Unc. [days]
pl_orbtpererr2	Epoch of Periastron Lower Unc. [days]
pl_orbtperlim	Epoch of Periastron Limit Flag
pl_orbtper_systemref	Epoch of Periastron Time System Frame and Standard
pl_orbtper_reflink	Epoch of Periastron Reference
pl_orblper	Argument of Periastron [deg]
pl_orblpererr1	Argument of Periastron Upper Unc. [deg]
pl_orblpererr2	Argument of Periastron Lower Unc. [deg]
pl_orblperlim	Argument of Periastron Limit Flag
pl_orblper_reflink	Argument of Periastron Reference
pl_rvamp	Radial Velocity Amplitude [m/s]
pl_rvamperr1	Radial Velocity Amplitude Upper Unc. [m/s]
pl_rvamperr2	Radial Velocity Amplitude Lower Unc. [m/s]
pl_rvamplim	Radial Velocity Amplitude Limit Flag
pl_rvamp_reflink	Radial Velocity Amplitude Reference
pl_projobliq	Projected Obliquity [deg]
pl_projobliqerr1	Projected Obliquity Upper Unc. [deg]
pl_projobliqerr2	Projected Obliquity Lower Unc. [deg]
pl_projobliqlim	Projected Obliquity Limit Flag
pl_projobliq_reflink	Projected Obliquity Reference
pl_trueobliq	True Obliquity [deg]
pl_trueobliqerr1	True Obliquity Upper Unc. [deg]
pl_trueobliqerr2	True Obliquity Lower Unc. [deg]
pl_trueobliqlim	True Obliquity Limit Flag
pl_trueobliq_reflink	True Obliquity Reference
st_spectype	Spectral Type
st_spectype_reflink	Spectral Type Reference
st_teff	Stellar Effective Temperature [K]
st_tefferr1	Stellar Effective Temperature Upper Unc. [K]
st_tefferr2	Stellar Effective Temperature Lower Unc. [K]
st_tefflim	Stellar Effective Temperature Limit Flag
st_teff_reflink	Stellar Effective Temperature Reference
st_rad	Stellar Radius [Solar Radius]
st_raderr1	Stellar Radius Upper Unc. [Solar Radius]
st_raderr2	Stellar Radius Lower Unc. [Solar Radius]
st_radlim	Stellar Radius Limit Flag
st_rad_reflink	Stellar Radius Reference
st_mass	Stellar Mass [Solar mass]
st_masserr1	Stellar Mass Upper Unc. [Solar mass]
st_masserr2	Stellar Mass Lower Unc. [Solar mass]
st_masslim	Stellar Mass Limit Flag
st_mass_reflink	Stellar Mass [Solar mass] Reference
st_met	Stellar Metallicity [dex]
st_meterr1	Stellar Metallicity Upper Unc. [dex]
st_meterr2	Stellar Metallicity Lower Unc. [dex]
st_metlim	Stellar Metallicity Limit Flag
st_met_reflink	Stellar Metallicity Reference
st_metratio	Stellar Metallicity Ratio
st_lum	Stellar Luminosity [log(Solar)]
st_lumerr1	Stellar Luminosity Upper Unc. [log(Solar)]
st_lumerr2	Stellar Luminosity Lower Unc. [log(Solar)]
st_lumlim	Stellar Luminosity Limit Flag
st_lum_reflink	Stellar Luminosity Reference
st_logg	Stellar Surface Gravity [log10(cm/s**2)]
st_loggerr1	Stellar Surface Gravity Upper Unc. [log10(cm/s**2)]
st_loggerr2	Stellar Surface Gravity Lower Unc. [log10(cm/s**2)]
st_logglim	Stellar Surface Gravity Limit Flag
st_logg_reflink	Stellar Surface Gravity Reference
st_age	Stellar Age [Gyr]
st_ageerr1	Stellar Age Upper Unc. [Gyr]
st_ageerr2	Stellar Age Lower Unc. [Gyr]
st_agelim	Stellar Age Limit Flag
st_age_reflink	Stellar Age Reference
st_dens	Stellar Density [g/cm**3]
st_denserr1	Stellar Density Upper Unc. [g/cm**3]
st_denserr2	Stellar Density Lower Unc. [g/cm**3]
st_denslim	Stellar Density Limit Flag
st_dens_reflink	Stellar Density Reference
st_vsin	Stellar Rotational Velocity [km/s]
st_vsinerr1	Stellar Rotational Velocity [km/s] Upper Unc.
st_vsinerr2	Stellar Rotational Velocity [km/s] Lower Unc.
st_vsinlim	Stellar Rotational Velocity Limit Flag
st_vsin_reflink	Stellar Rotational Velocity Reference
st_rotp	Stellar Rotational Period [days]
st_rotperr1	Stellar Rotational Period [days] Upper Unc.
st_rotperr2	Stellar Rotational Period [days] Lower Unc.
st_rotplim	Stellar Rotational Period Limit Flag
st_rotp_reflink	Stellar Rotational Period Reference
st_radv	Systemic Radial Velocity [km/s]
st_radverr1	Systemic Radial Velocity Upper Unc. [km/s]
st_radverr2	Systemic Radial Velocity Lower Unc. [km/s]
st_radvlim	Systemic Radial Velocity Limit Flag
st_radv_reflink	Systemic Radial Velocity Reference
rastr	RA [sexagesimal]
ra	RA [decimal]
decstr	Dec [sexagesimal]
dec	Dec [decimal]
raerr1	RA Upper Unc
raerr2	RA Lower Unc
decerr1	Dec Upper Unc
decerr2	Dec Lower Unc
glat	Galactic Latitude [deg]
glaterr1	Galactic Latitude [deg] Upper Unc
glaterr2	Galactic Latitude [deg] Lower Unc
glon	Galactic Longitude [deg]
glonerr1	Galactic Longitude [deg] Upper Unc
glonerr2	Galactic Longitude [deg] Lower Unc
elat	Ecliptic Latitude [deg]
elaterr1	Ecliptic Latitude [deg] Upper Unc
elaterr2	Ecliptic Latitude [deg] Lower Unc
elon	Ecliptic Longitude [deg]
elonerr1	Ecliptic Longitude [deg] Upper Unc
elonerr2	Ecliptic Longitude [deg] Lower Unc
ra_reflink	Position Reference
sy_pm	Total Proper Motion [mas/yr]
sy_pmerr1	Total Proper Motion Upper Unc [mas/yr]
sy_pmerr2	Total Proper Motion Lower Unc [mas/yr]
sy_pm_reflink	Total Proper Motion Reference
sy_pmra	Proper Motion (RA) [mas/yr]
sy_pmraerr1	Proper Motion (RA) [mas/yr] Upper Unc
sy_pmraerr2	Proper Motion (RA) [mas/yr] Lower Unc
sy_pmra_reflink	Proper Motion (RA) Reference
sy_pmdec	Proper Motion (Dec) [mas/yr]
sy_pmdecerr1	Proper Motion (Dec) [mas/yr] Upper Unc
sy_pmdecerr2	Proper Motion (Dec) [mas/yr] Lower Unc
sy_pmdec_reflink	Proper Motion (Dec) Reference
sy_dist	Distance [pc]
sy_disterr1	Distance [pc] Upper Unc
sy_disterr2	Distance [pc] Lower Unc
sy_dist_reflink	Distance Reference
sy_plx	Parallax [mas]
sy_plxerr1	Parallax [mas] Upper Unc
sy_plxerr2	Parallax [mas] Lower Unc
sy_plx_reflink	Parallax Reference
sy_bmag	B (Johnson) Magnitude
sy_bmagerr1	B (Johnson) Magnitude Upper Unc
sy_bmagerr2	B (Johnson) Magnitude Lower Unc
sy_bmag_reflink	B (Johnson) Magnitude Reference
sy_vmag	V (Johnson) Magnitude
sy_vmagerr1	V (Johnson) Magnitude Upper Unc
sy_vmagerr2	V (Johnson) Magnitude Lower Unc
sy_vmag_reflink	V (Johnson) Magnitude Reference
sy_jmag	J (2MASS) Magnitude
sy_jmagerr1	J (2MASS) Magnitude Upper Unc
sy_jmagerr2	J (2MASS) Magnitude Lower Unc
sy_jmag_reflink	J (2MASS) Magnitude Reference
sy_hmag	H (2MASS) Magnitude
sy_hmagerr1	H (2MASS) Magnitude Upper Unc
sy_hmagerr2	H (2MASS) Magnitude Lower Unc
sy_hmag_reflink	H (2MASS) Magnitude Reference
sy_kmag	Ks (2MASS) Magnitude
sy_kmagerr1	Ks (2MASS) Magnitude Upper Unc
sy_kmagerr2	Ks (2MASS) Magnitude Lower Unc
sy_kmag_reflink	K2 (2MASS) Magnitude Reference
sy_umag	u (Sloan) Magnitude
sy_umagerr1	u (Sloan) Magnitude Upper Unc
sy_umagerr2	u (Sloan) Magnitude Lower Unc
sy_umag_reflink	u (Sloan) Magnitude Reference
sy_gmag	g (Sloan) Magnitude
sy_gmagerr1	g (Sloan) Magnitude Upper Unc
sy_gmagerr2	g (Sloan) Magnitude Lower Unc
sy_gmag_reflink	g (Sloan) Magnitude Reference
sy_rmag	r (Sloan) Magnitude
sy_rmagerr1	r (Sloan) Magnitude Upper Unc
sy_rmagerr2	r (Sloan) Magnitude Lower Unc
sy_rmag_reflink	r (Sloan) Magnitude Reference
sy_imag	i (Sloan) Magnitude
sy_imagerr1	i (Sloan) Magnitude Upper Unc
sy_imagerr2	i (Sloan) Magnitude Lower Unc
sy_imag_reflink	i (Sloan) Magnitude Reference
sy_zmag	z (Sloan) Magnitude
sy_zmagerr1	z (Sloan) Magnitude Upper Unc
sy_zmagerr2	z (Sloan) Magnitude Lower Unc
sy_zmag_reflink	z (Sloan) Magnitude Reference
sy_w1mag	W1 (WISE) Magnitude
sy_w1magerr1	W1 (WISE) Magnitude Upper Unc
sy_w1magerr2	W1 (WISE) Magnitude Lower Unc
sy_w1mag_reflink	W1 (WISE) Magnitude Reference
sy_w2mag	W2 (WISE) Magnitude
sy_w2magerr1	W2 (WISE) Magnitude Upper Unc
sy_w2magerr2	W2 (WISE) Magnitude Lower Unc
sy_w2mag_reflink	W2 (WISE) Magnitude Reference
sy_w3mag	W3 (WISE) Magnitude
sy_w3magerr1	W3 (WISE) Magnitude Upper Unc
sy_w3magerr2	W3 (WISE) Magnitude Lower Unc
sy_w3mag_reflink	W3 (WISE) Magnitude Reference
sy_w4mag	W4 (WISE) Magnitude
sy_w4magerr1	W4 (WISE) Magnitude Upper Unc
sy_w4magerr2	W4 (WISE) Magnitude Lower Unc
sy_w4mag_reflink	W4 (WISE) Magnitude Reference
sy_gaiamag	Gaia Magnitude
sy_gaiamagerr1	Gaia Magnitude Upper Unc
sy_gaiamagerr2	Gaia Magnitude Lower Unc
sy_gaiamag_reflink	Gaia Magnitude Reference
sy_icmag	I (Cousins) Magnitude
sy_icmagerr1	I (Cousins) Magnitude Upper Unc
sy_icmagerr2	I (Cousins) Magnitude Lower Unc
sy_icmag_reflink	I (Cousins) Magnitude Reference
sy_tmag	TESS Magnitude
sy_tmagerr1	TESS Magnitude Upper Unc
sy_tmagerr2	TESS Magnitude Lower Unc
sy_tmag_reflink	TESS Magnitude Reference
sy_kepmag	Kepler Magnitude
sy_kepmagerr1	Kepler Magnitude Upper Unc
sy_kepmagerr2	Kepler Magnitude Lower Unc
sy_kepmag_reflink	Kepler Magnitude Reference
pl_nnotes	Number of Notes
st_nphot	Number of Photometry Time Series
st_nrvc	Number of Radial Velocity Time Series
st_nspec	Number of Stellar Spectra Measurements
pl_nespec	Number of Emission Spectroscopy Measurements
pl_ntranspec	Number of Transmission Spectroscopy Measurements
